[paste.app_factory]
mem_object = swift.obj.mem_server:app_factory
account = swift.account.server:app_factory
object = swift.obj.server:app_factory
container = swift.container.server:app_factory
proxy = swift.proxy.server:app_factory

[paste.filter_factory]
formpost = swift.common.middleware.formpost:filter_factory
gatekeeper = swift.common.middleware.gatekeeper:filter_factory
container_quotas = swift.common.middleware.container_quotas:filter_factory
container_sync = swift.common.middleware.container_sync:filter_factory
catch_errors = swift.common.middleware.catch_errors:filter_factory
ratelimit = swift.common.middleware.ratelimit:filter_factory
xprofile = swift.common.middleware.xprofile:filter_factory
keystoneauth = swift.common.middleware.keystoneauth:filter_factory
tempauth = swift.common.middleware.tempauth:filter_factory
list_endpoints = swift.common.middleware.list_endpoints:filter_factory
dlo = swift.common.middleware.dlo:filter_factory
name_check = swift.common.middleware.name_check:filter_factory
domain_remap = swift.common.middleware.domain_remap:filter_factory
proxy_logging = swift.common.middleware.proxy_logging:filter_factory
crossdomain = swift.common.middleware.crossdomain:filter_factory
healthcheck = swift.common.middleware.healthcheck:filter_factory
tempurl = swift.common.middleware.tempurl:filter_factory
bulk = swift.common.middleware.bulk:filter_factory
memcache = swift.common.middleware.memcache:filter_factory
account_quotas = swift.common.middleware.account_quotas:filter_factory
staticweb = swift.common.middleware.staticweb:filter_factory
cname_lookup = swift.common.middleware.cname_lookup:filter_factory
recon = swift.common.middleware.recon:filter_factory
slo = swift.common.middleware.slo:filter_factory

